.................
.           .   .
. ... ..... . ...
. . . .     .   .
... . . . ... . .
.     . .     . .
. . ... ... ... .
. .         .   .
. ... ..... .....
.     .   .*    .
... ... . ... . .
.   .   .     . .
..... ... ... . .
.   . .   .   . .
. . . . ... ... .
.*.   . .x  .   .
.................