.........................
.x    .   .     .   .  *.
. ... . . . ... . . . ...
. . .   . .   .   . .   .
. . ..... ... ..... ... .
.   .     .       .   . .
... . ... . . ... . . . .
. . .   .   .   .   .   .
. . ... ....... ..... ...
.       .   .   .   . . .
....... ... . . . . . . .
.   .       . .   .     .
. . . ... ... . ... .....
. .   .   .   . .   .   .
. ..... ... ....... . . .
.     .     . .       . .
..... ... . . . ..... . .
.   . .   .   .     .   .
. . . . ..... ... . .....
. .     .   .   . .     .
....... ... . . ... .....
.   .     .   . .   .   .
. . . ... . ... . . . . .
.*.   .     .   . .   .*.
.........................