.....................................
.   .       . . .*  .   .     .     .
. . ......... . ... . ... . ... ... .
.   .   . . . . .     .   . .    *. .
. ... . . . . . ..... . ... ....... .
. . .   . . . . .   .   .   .     . .
. . . . . . . . . . ... ..... . ... .
. . . . .   . . . . .   .     .     .
... ........... ... . ....... ..... .
.               .     .     .   .   .
..................... . . . ... . ...
.     .     .   .     . . . .   .   .
... . . . ..... . ....... . ... ... .
.   .   .   .     .*.     .     .   .
. ... . ... . ..... . . ..... ... ...
.   . .   .   .     . .       .     .
... . ....... . ..... ..... . . ... .
. .         .   .x.   .     . . . . .
. . ..... . . ... . . . ....... . ...
.     .   .     .   .       .   .   .
..... ..... ... ....... ... . . . . .
. .   . .     . .   . .   . . .   . .
. . ... ......... . . ... . . .......
.   .   .     .   .   . . . .   .   .
... . ..... ......... . . ..... . . .
. .     .       .   .   .   . .   . .
. . ... . ..... . . ... ... . . ... .
.   .       .     .     .   .   .   .
... ......... ... ... ....... ... . .
.   .  *.     . . .   .       .   . .
. ... ... ..... . . ... . ... ... . .
.     .   .       .     .   .   . . .
..... . ... ... ... ....... ... ... .
.     . .   .     .   .     .   .   .
. ..... . ..... . . . . . ... . ... .
.   .     .     .   .   . .   .     .
.....................................