.............................................................
.   .   .       .       .     .         .   .   .   .       .
. . . ..... ... . ... . . . . ... ..... . . . ... . . ..... .
. .       .   .   .   .   . .   . .   . . .       .       . .
. ....... ... ..... ....... ... . . ... . ....... ... . ... .
.       .                 .   .   . .   . .   .       . .   .
... ... ... ..... ....... . . . ... . ... . . . ......... ...
.   .     .     .     .   . . .   .   .     .   .       .   .
. ... . . ..... ..... . . ... ... ... . . ..... . ..... ... .
.   . . .     .   .   . .           .   .     . . .   .   . .
... ... ... ......... . ... ... . . ..... ... . . . ..... . .
.   . . .   .       .       .   . .             .       .   .
. ... . . . ... ... ..... ... . . ... . ... . ..... ... ... .
.     .   .     .   .         .   .   . .   . .     .       .
..... . ... ... . ... ..... ..... . ... ..... . ..... .......
. .   .       . .   .   .   . .   . .     .   .           . .
. . . ..... . . . . ... . ... . ... . ... . ..... ... ... . .
.   . .   . .     .   .         .     . . . .   .   . .     .
..... . . ... ....... ... . ..... ..... . . . . ... . .......
.     . .   . .       .   . . .   .   .     . .   .   . .   .
. ... ..... . . ............. . . ... ... ... ... . . . ... .
.   .   .   .     .   .     .   .     .   .   .   . .       .
... . ... ... ... . . . ... ....... ... . . ... ..... . .....
.   .   . .   . . . .     .   .   .     . .     .     . .   .
. . ... . . ... . . ..... . ... . ............. . . ... . . .
. .   .   .     . .   .         . .   .   .       .       . .
. ... ... . ... . ... ........... . ..... . ... . ....... . .
.     .   .   .   . .     .       .       . .   .     .   . .
..... . ... . ... . ..... . . ... . . ....... ... ... .......
.   .   .   .       .   .   .   .   . . .         .         .
... ....... ..... ... . ..... ....... . . ... . ....... . . .
.         . .   . .   . .     .     . .   .   .     .   . . .
. ... ... . . . . ... ... ....... . . ... . ....... . . . ...
.   .   .   . .   .       .       .   . .   .   .     .     .
... ... ......... . ... ... ..... ... . . ... . . ... ... . .
. . .       .   . .   .   .   . .   .   .     .   .   .   . .
. . ... ... ... ..... ....... . . ... ... ... ...............
.     .   . .   .   . .       .   .   .   .                 .
... . ... ... ... ... . ........... ... ... ... . ... . . ...
.   .   . .   .       .     .       . .       . .   . . .   .
. ..... . . ......... ... ... . ... . ..... . . . ... . . ...
. .     . . .   .   .   . .   .   .   .   . . . .   . . .   .
. ..... . . ... . . ... . . ... . ..... . ... . ... ... ... .
.   .     .   . . .     .   .   .     . . .   .             .
... . . ..... . ... ....... ... ..... . . ... ..... ..... ...
.   . . .   .         .   . .   .   .   .   .               .
. . ..... . ... ... ... . . . ... ... ..... ............... .
. .     . . . . .   .   . . . . .   . .   .   .     .     . .
. ..... . ... ... ..... ... . . ... ..... . ... ... . . ... .
. .   . .   .     .   .     .   .     .         . .   . .   .
... ... ... ... ... . . ..... ... . . . ..... . . . ... . ...
.       .   .       .     .       . . .     . .   . . . .   .
. ....... ... . ......... . . ..... . ... . ... ... . ..... .
.   . .       .     .   .   . .     .   . .     .     .   . .
... . . ... ......... ....... . . ..... ..... . ... ... . . .
.   .   .           .   . .     . .   .   .   .   .   . . . .
. ... . ....... ... ... . ..... ... . ... . ... . ... . . . .
.*.   .       .   .   .   .   .     . .   . .   . .     . . .
... ... ... . . . ... ... . . . ..... . . . . ... . . ... . .
.x      .   .   .   .     . .     .   . .     .   . .       .
.............................................................