.........................................................
.x.   .     .   .     .   .     .       .       .   .   .
. ... ... . . ... . . ... . . ... . ... ... . ..... ... .
.     .     .     .     .     .   .   .   .   .       . .
... ... . ... ... ... . ... . . . ... . . . . ... ... . .
. .             .                                 . .   .
. . ... . . . . . . . . . . . . . . . . . . . . . . . ...
.   .                                               .   .
... . . ....... . ....... . . ..... . ... ... ... . ... .
.       .     .   .     .     .   .   . . . . . .       .
. ... . . ... ... . ... ... ... . ... . . . . . . . . . .
. .     . . .   . . . .   . .   .   . . . . . . .       .
. . . . . . ... . . . ... . . ..... . . . . . . . . . ...
.   .   . .   . . . .   . . . .   . . . . . . . .     . .
..... . . . . . . . ..... . . ..... . . . . . . . . . . .
.       . .   . . .       . .       . . . . . . .       .
. . . . . . . . . . ... ... . ..... . . . . . . . . ... .
. .     . .   . . . . . .   . .   . . . . . . . .     . .
... . . . . ... . . . . ... . . . . . . ... ... . . . . .
.       . . .   . . . .   . . .   . . .         .       .
. ... . . ... ... . . ... . . . . . . ... ... ... . . ...
.   .   .     .   . .   . . . .   . .   . . . .       . .
. . . . ....... . ... . ... ... . ... . ... ... . . . . .
. .                                               .     .
. ... . . . . . . ....... ... ... ..... . . . . ... ... .
.   . .           .     . . . . . .   .               . .
. . . ... . . . . ... ... . . . . . ... . . . . . . . ...
.     .   .         . .   . . . . . .           . .     .
..... . . ... . . . . . . . ... . . ... . . . ... ..... .
.   .   .           . .   .     . .   .             .   .
. . ... . . ... . . . . . . ... . . ... . . ... ..... ...
. .     .   .       . .   . . . . . .         .   .   . .
... ..... ... . . . . . . . . . . . ... . . . ... . . . .
.                   . .   . . . . .   .             .   .
. . ... . . . . . . ... . ... ... ..... . . . . . . ... .
. .   .                                                 .
. ... . . ... ... . . ..... . ......... ......... . . ...
.         . . . .     .   .   .       . .       .     . .
. . . . ... ... ... ... . ... ....... . . ....... . . . .
.   .   .         . .   .   .       . . . .             .
..... . . ... ... . . ..... . . . ... . . . . . . . ... .
.       . . . . . . . .   . .     .   . . .           . .
. . . . . . . . . . . ..... . . ... ... . ....... . .....
. .     . . . . . . .       .   .   .   .       .       .
. ... . . . . . . . . ..... . ... ... . . ....... . . . .
.       . . . . . . . .   . . .   .     . .             .
... . . . . . . . . . . . . . . ... . . . . . . . . . ...
.       . . . . . . . .   . . . .       . .           . .
. ... . . . . . . . . . . . . . ....... . ....... . . . .
.   .   . . . . . . . .   . . .       . .       .       .
... . . ... ... ... ... . ... ......... ......... . .....
. .                                                     .
. ..... . . . . . . . . . ... . ... . . . . . . . ... ...
.         .     .     .     .     .   .   .   .     . . .
..... ... ....... . ... ... . ... . ... . ... ... ... . .
.     .       .   . .   .   .   .       .   .     .    *.
.........................................................