.........................................................
.x.   .     .   .     .   .     .       .       .   .   .
. ... ... . . ... . . ... . . ... . ... ... . ..... ... .
.     .     .     .     .     .   .   .   .   .       . .
... ... . ... ... ... . ... . . . ... . . . . ... ... . .
. .             .                                 . .   .
. . ... . . . . . . . . . . . . . . . . . . . . . . . ...
.   .                                               .   .
... . . ....... . ....... . . ..... . ... ... ... . ... .
.       .* * *.   .* * *.     .* *.   .*. .*. .*.       .
. ... . . ... ... . ... ... ... . ... . . . . . . . . . .
. .     .*. .* *. .*. .* *. .* *.* *. .*. .*. .*.       .
. . . . . . ... . . . ... . . ..... . . . . . . . . . ...
.   .   .*.   .*. .*.   .*. .*.   .*. .*. .*. .*.     . .
..... . . . . . . . ..... . . ..... . . . . . . . . . . .
.       .*.   .*. .* * * *. .* * * *. .*. .*. .*.       .
. . . . . . . . . . ... ... . ..... . . . . . . . . ... .
. .     .*.   .*. .*. .*.   .*.   .*. .*. .*. .*.     . .
... . . . . ... . . . . ... . . . . . . ... ... . . . . .
.       .*. .* *. .*. .* *. .*.   .*. .* * * * *.       .
. ... . . ... ... . . ... . . . . . . ... ... ... . . ...
.   .   .* * *    .*.   .*. .*.   .*.   .*. .*.       . .
. . . . ....... . ... . . . ... . . . . ... . . . . . . .
. .                                               .     .
. ... . . . . . . ....... ... ... ..... . . . . ... ... .
.   . .           .* * *. .*. .*. .* *.               . .
. . . ... . . . . ... ... . . . . . ... . . . . . . . ...
.     .   .         .*.   .*. .*. .*.           . .     .
..... . . ... . . . . . . . ... . . ... . . . ... ..... .
.   .   .           .*.   .* * *. .* *.             .   .
. . ... . . ... . . . . . . ... . . ... . . ... ..... ...
. .     .   .       .*.   .*. .*. .*.         .   .   . .
... ..... ... . . . . . . . . . . . ... . . . ... . . . .
.                   .*.   .*. .*. .* *              .   .
. . ... . . . . . . . . . ... . . ..... . . . . . . ... .
. .   .                                                 .
. ... . . ... ... . . ..... . ......... ......... . . ...
.         .*. . .     .* *.   .* * * *. .* * * *.     . .
. . . . ... ... ... ... . ... ....... . . ....... . . . .
.   .   .* * * * *. .* *.* *.       .*. .*.             .
..... . . ... ... . . ..... . . . ... . . . . . . . ... .
.       .*. .*. .*. .*.   .*.     .* *. .*.           . .
. . . . . . . . . . . ..... . . ... ... . ....... . .....
. .     .*. .*. .*. .* * * *.   .* *.   .* * * *.       .
. ... . . . . . . . . ..... . ... ... . . ....... . . . .
.       .*. .*. .*. .*.   .*. .* *.     .*.             .
... . . . . . . . . . . . . . . ... . . . . . . . . . ...
.       .*. .*. .*. .*.   .*. .*.       .*.           . .
. ... . . . . . . . . . . . . . ....... . ....... . . . .
.   .   .*. .*. .*. .*.   .*. .* * * *  .* * * *        .
... . . ... ... . . ... . . . ......... ......... . .....
. .                                                     .
. ..... . . . . . . . . . ... . ... . . . . . . . ... ...
.         .     .     .     .     .   .   .   .     . . .
..... ... ....... . ... ... . ... . ... . ... ... ... . .
.     .       .   . .   .   .   .       .   .     .     .
.........................................................
